#################
#P......#.......#
#.##.##.#.##.##.#
#...............#
#.##.#.###.#.##.#
#....#..#..#....#
#.##.##.#.##.####
#.##.#.....#.####
#......###......#
#.##.#.GGG.#.##.#
#.##.#.###.#.##.#
#.......#.......#
#.##.##.#.#####.#
#..#.........#..#
##.#.#.###.#.#.##
#....#..#..#....#
#.#####.#.#####.#
#...............#
#################